NO ./textures/bmw.xpm
SO ./textures/ferrari.xpm
WE ./textures/mclaren.xpm
EA ./textures/porsche.xpm

F 50,50,50
C 135,206,235

        1111111111111111111111111
        1000000000110000000000001
        1011000001110000000000001
        1001000000000000000000001
111111111011000001110000000000001
100000000011000001110111111111111      11111
11110111111111011100000010001          10001
11110111111111011101010010001          11111
11000000110101011100000010001
10000000000000001100000010001
10000000000000001101010000001
11000001110101011111011110N0111
11110111 1110101 101111010001
11111111 1111111 111111111111
1111

1

1111111
1000001
1111111